f######a######
#            #
#            #
#            #
#            l
#            #
#            #
#######b######
:name:frontgarden
:scary:not

a##
#
#
#
#f#
:name:home

l#############
#
#
#
f
#
#
#
#
#